+---+---+---+---+---+---+---+---+---+---+---+---+---+---+---+---+---+---+---+---+
| /   /   /   /   /   /   /   /   /   /   /   /   /   /   /   /   /   /   /   / |
+   +   +   +   +   +   +   +   +   +   +   +   +   +   +   +   +   +   +   +   +
| /   /   /   /   /   /   /   /   /   /   /   /   /   /   /   /   /   /   /   / |
+   +   +   +   +   +   +   +   +   +   +   +   +   +   +   +   +   +   +   +   +
| /   /   /   /   /   /   /   /   /   /   /   /   /   /   /   /   /   /   /   / |
+   +   +   +   +   +   +   +   +   +   +   +   +   +   +   +   +   +   +   +   +
| /   /   /   /   /   /   /   /   /   /   /   /   /   /   /   /   /   /   /   / |
+   +   +   +   +   +   +   +   +   +   +   +   +   +   +   +   +   +   +   +   +
| /   /   /   /   /   /   /   /   /   /   /   /   /   /   /   /   /   /   /   / |
+   +   +   +   +   +   +   +   +   +   +   +   +   +   +   +   +   +   +   +   +
| /   /   /   /   /   /   /   /   /   /   /   /   /   /   /   /   /   /   /   / |
+   +   +   +   +   +   +   +   +   +   +   +   +   +   +   +   +   +   +   +   +
| /   /   /   /   /   /                                   /   /   /   /   /   / |
+   +   +   +   +   +   +   +   +   +   +   +   +   +   +   +   +   +   +   +   +
| /   /   /   /   /   /                                   /   /   /   /   /   / |
+   +   +   +   +   +   +   +   +   +   +   +   +   +   +   +   +   +   +   +   +
| /   /   /   /   /   /               #   #               /   /   /   /   /   / |
+   +   +   +   +   +   +   +   +   +   +   +   +   +   +   +   +   +   +   +   +
| /   /   /   /   /   /               S                   /   /   /   /   /   / |
+   +   +   +   +   +   +   +   +   +   +   +   +   +   +   +   +   +   +   +   +
| /   /   /   /   /   /                                   /   /   /   /   /   / |
+   +   +   +   +   +   +   +   +   +   +   +   +   +   +   +   +   +   +   +   +
| /   /   /   /   /   /               #   #               /   /   /   /   /   / |
+   +   +   +   +   +   +   +   +   +   +   +   +   +   +   +   +   +   +   +   +
| /   /   /   /   /   /                                   /   /   /   /   /   / |
+   +   +   +   +   +   +   +   +   +   +   +   +   +   +   +   +   +   +   +   +
| /   /   /   /   /   /                                   /   /   /   /   /   / |
+   +   +   +   +   +   +   +   +   +   +   +   +   +   +   +   +   +   +   +   +
| /   /   /   /   /   /   /   /   /   /   /   /   /   /   /   /   /   /   /   / |
+   +   +   +   +   +   +   +   +   +   +   +   +   +   +   +   +   +   +   +   +
| /   /   /   /   /   /   /   /   /   /   /   /   /   /   /   /   /   /   /   / |
+   +   +   +   +   +   +   +   +   +   +   +   +   +   +   +   +   +   +   +   +
| /   /   /   /   /   /   /   /   /   /   /   /   /   /   /   /   /   /   /   / |
+   +   +   +   +   +   +   +   +   +   +   +   +   +   +   +   +   +   +   +   +
| /   /   /   /   /   /   /   /   /   /   /   /   /   /   /   /   /   /   /   / |
+   +   +   +   +   +   +   +   +   +   +   +   +   +   +   +   +   +   +   +   +
| /   /   /   /   /   /   /   /   /   /   /   /   /   /   /   /   /   /   /   / |
+   +   +   +   +   +   +   +   +   +   +   +   +   +   +   +   +   +   +   +   +
| /   /   /   /   /   /   /   /   /   /   /   /   /   /   /   /   /   /   /   / |
+---+---+---+---+---+---+---+---+---+---+---+---+---+---+---+---+---+---+---+---+