+---+---+---+---+---+---+---+---+---+---+---+---+---+---+---+---+---+---+---+---+
| #   #   #                                                           #   #   # |
+   +   +   +   +   +   +   +   +   +   +   +   +   +   +   +   +   +   +   +   +
| #   #   #                                                           #   #   # |
+   +   +   +   +   +   +   +   +   +   +   +   +   +   +   +   +   +   +   +   +
| #   #   #                                                           #   #   # |
+   +   +   +   +   +   +   +   +   +   +   +   +   +   +   +   +   +   +   +   +
|                                                                               |
+   +   +   +   +   +   +   +   +   +   +   +   +   +   +   +   +   +   +   +   +
|                     #   #   #   #           #   #   #   #                     |
+   +   +   +   +   +   +   +   +   +   +   +   +   +   +   +   +   +   +   +   +
|                     #   #   #   #           #   #   #   #                     |
+   +   +   +   +   +   +   +   +   +   +   +   +   +   +   +   +   +   +   +   +
|                     #   #   #   #           #   #   #   #                     |
+   +   +   +   +   +   +   +   +   +   +   +   +   +   +   +   +   +   +   +   +
|                     #   #   #   #           #   #   #   #                     |
+   +   +   +   +   +   +   +   +   +   +   +   +   +   +   +   +   +   +   +   +
|                     #   #   #   #           #   #   #   #                     |
+   +   +   +   +   +   +   +   +   +   +   +   +   +   +   +   +   +   +   +   +
|                                     S                                         |
+   +   +   +   +   +   +   +   +   +   +   +   +   +   +   +   +   +   +   +   +
|                                                                               |
+   +   +   +   +   +   +   +   +   +   +   +   +   +   +   +   +   +   +   +   +
|                     #   #   #   #           #   #   #   #                     |
+   +   +   +   +   +   +   +   +   +   +   +   +   +   +   +   +   +   +   +   +
|                     #   #   #   #           #   #   #   #                     |
+   +   +   +   +   +   +   +   +   +   +   +   +   +   +   +   +   +   +   +   +
|                     #   #   #   #           #   #   #   #                     |
+   +   +   +   +   +   +   +   +   +   +   +   +   +   +   +   +   +   +   +   +
|                     #   #   #   #           #   #   #   #                     |
+   +   +   +   +   +   +   +   +   +   +   +   +   +   +   +   +   +   +   +   +
|                     #   #   #   #           #   #   #   #                     |
+   +   +   +   +   +   +   +   +   +   +   +   +   +   +   +   +   +   +   +   +
|                                                                               |
+   +   +   +   +   +   +   +   +   +   +   +   +   +   +   +   +   +   +   +   +
| #   #   #                                                           #   #   # |
+   +   +   +   +   +   +   +   +   +   +   +   +   +   +   +   +   +   +   +   +
| #   #   #                                                           #   #   # |
+   +   +   +   +   +   +   +   +   +   +   +   +   +   +   +   +   +   +   +   +
| #   #   #                                                           #   #   # |
+---+---+---+---+---+---+---+---+---+---+---+---+---+---+---+---+---+---+---+---+