+---+---+---+---+---+---+---+---+---+---+---+---+---+---+---+---+---+---+---+---+
| V   V   V   #   #   #   #   #   #   #   #   #   #   #   #   #   #   V   V   V |
+   +   +   +   +   +   +   +   +   +   +   +   +   +   +   +   +   +   +   +   +
| V   V   V   #                                                   #   V   V   V |
+   +   +   +   +   +   +   +   +   +   +   +   +   +   +   +   +   +   +   +   +
| V   V   V   #                                                   #   V   V   V |
+   +   +   +   +   +   +   +   +   +   +   +   +   +   +   +   +   +   +   +   +
| #   #   #   #                                                   #   #   #   # |
+   +   +   +   +   +   +   +   +   +   +   +   +   +   +   +   +   +   +   +   +
|                                                                               |
+   +   +   +   +   +   +   +   +   +   +   +   +   +   +   +   +   +   +   +   +
|                             V   V   V   V   V   V                             |
+   +   +   +   +   +   +   +   +   +   +   +   +   +   +   +   +   +   +   +   +
|                                 V           V       V                         |
+   +   +   +   +   +   +   +   +   +   +   +   +   +   +   +   +   +   +   +   +
|                                 V           V                                 |
+   +   +   +   +   +   +   +   +   +   +   +   +   +   +   +   +   +   +   +   +
|                                 V           V                                 |
+   +   +   +   +   +   +   +   +   +   +   +   +   +   +   +   +   +   +   +   +
|                                 V           S   V                             |
+   +   +   +   +   +   +   +   +   +   +   +   +   +   +   +   +   +   +   +   +
|                                                                               |
+   +   +   +   +   +   +   +   +   +   +   +   +   +   +   +   +   +   +   +   +
|             V                                                   V             |
+   +   +   +   +   +   +   +   +   +   +   +   +   +   +   +   +   +   +   +   +
|             V   V                                           V   V             |
+   +   +   +   +   +   +   +   +   +   +   +   +   +   +   +   +   +   +   +   +
|                 V   V           #   #   #   #           V   V                 |
+   +   +   +   +   +   +   +   +   +   +   +   +   +   +   +   +   +   +   +   +
|                     V               #   #               V                     |
+   +   +   +   +   +   +   +   +   +   +   +   +   +   +   +   +   +   +   +   +
|                         V   V                   V   V                         |
+   +   +   +   +   +   +   +   +   +   +   +   +   +   +   +   +   +   +   +   +
|                             V   V   V   V   V   V                             |
+   +   +   +   +   +   +   +   +   +   +   +   +   +   +   +   +   +   +   +   +
| V   V   V                                                           V   V   V |
+   +   +   +   +   +   +   +   +   +   +   +   +   +   +   +   +   +   +   +   +
| V   V   V                                                           V   V   V |
+   +   +   +   +   +   +   +   +   +   +   +   +   +   +   +   +   +   +   +   +
| V   V   V   #   #   #   #   #   #   #   #   #   #   #   #   #   #   V   V   V |
+---+---+---+---+---+---+---+---+---+---+---+---+---+---+---+---+---+---+---+---+